11111111111111
100000000000P1
10000000000001
10000000000001
10C000E0000001
11111111111111
