111111P11111111
100000100000001
100000P00000001
100000100000001
100000P00000001
111111111111111
