111111111111111111
100001000000000001
10000P00000E000001
100C010000000C0001
111111111111111111