1111111111111111111
1000010000000000011
10000P00000E0000011
100C010000000C00011
1111111111111111111